60 80
################################################################################
#S#.................................#......................#....................
#.#.###########################.###.#####################.###.##################
#.#.#...........................#...#...........................#...............
#.#.#######.#####################.#####################.#####.#.################
#.#.#.......#...................#.............................#.#.#.............
#.#.#.#####.#.#################.##################.##########.###.#.############
#.#.#...........................#.............................#...#.#...........
#.#.###########################.#.##############.########.#####.#.##############
#.#.#...........................#.............................#.#.#.#...........
#.#.#######.#####################.############.########.#.#####.#.##############
#.#.#.......#...................#.......................#.#.#...#.#.............
#.#.#.#####.#.#################.###.#########.#########.#.#.###.#.##############
#...#.....#.#.#.................#...........................#.....#.............
#.#########.#.#.#################.#.##########.############.#######.############
#.#.........#.#.............................................#.......#...........
#.#.#######.#.#.#################.###.#####################.#.#####.#.##########
#.#.#.......#.#.#.................#...........................#.#.#...#.#.......
#.#.#.#####.#.#.#.#################.###.###################.#.#.###.#.##########
#...#...#...#.#.#.#..........................................#.#.....#..........
#####.#.#.###.#.#.###################.#####################.#######.############
#.....#.#.#...#.#.#...................#.....................#.......#...........
#.#####.#.#.###.#.#.###########.#####.#.###################.#####.#.############
#.......#.#.....#.#...................#.#...................#.....#.#...........
##########.#####.#.##############.####.#.#####.#############.#####.#.###########
#.........#.......#...................#.....................#.......#...........
#.#######.#.#####.#.############.####.#.###################.#####.#.############
#.#.....#.#.#.....#.#.................#...........................#.#...........
#.#.#.#.#.#.#.#####.#.###########.#####.#####################.###.#.############
#.#.#.#.#.#.#.#.....#...................#.....................#...#.#...........
#.#.#.#.#.#.#.#.#####.############.####.#.###################.###.#.############
#.#...#.#.#...#.#.......................#.....................#...#.#...........
#.#####.#.#####.#.###############.#####.#.#########.###########.###.############
#...............#.......................#.......................#...............
#####.#.#.###.#.#.###################.########.############.#######.############
#.....#.#.#...#.#.#...................#.....................#.......#...........
#.#####.#.#.###.#.#.#############.###.#.###################.#####.#.############
#.......#.#.....#.#...................#.#...................#.....#.#...........
##########.#####.#.#################.#.#.###################.#####.#.###########
#.........#.......#...................#.#...................#.......#...........
#.#######.#.#####.#.########.########.#.###########.#######.#####.#.############
#.#.....#.#.#.....#.#.................#.....................#.....#.#...........
#.#.#.#.#.#.#.#####.#.#################.##########.##########.###.#.############
#.#.#.#.#.#.#.#.....#...................#.....................#...#.#...........
#.#.#.#.#.#.#.#.#####.#################.#.###################.###.#.############
#.#...#.#.#...#.#.......................#.....................#...#.#...........
#.#####.#.#####.#.#####################.#.#####################.###.############
#...............#.......................#.......................#...............
#.#####.#.#####.#.#####################.#.#####################.###.############
#...............#.......................#.......................#...............
#####.#.#.###.#.#.###################.#####################.#######.############
#.....#.#.#...#.#.#...................#.....................#.......#...........
#.#####.#.#.###.#.#.#################.#.###################.#####.#.############
#.......#.#.....#.#...................#.#...................#.....#.#...........
##########.#####.#.#################.#.#.###################.#####.#.###########
#.........#.......#...................#.#...................#.......#...........
#.#######.#.#####.#.#################.#####################.#####.#.############
#.#.....#.#.#.....#.#.......................E...............#.....#.#...........
#.#.#.#.#.#.#.#####.#.#################.#####################.###.#.############
#.#.#.#.#.#.#.#####.#.#################.#####################.###.#.############
