10 30
########################################################################
#S#....................................................................#
#.#...###....###.##.#.##E#...........................................#
#.#.#.#.#..#...#.##.#.##.#.........................................#
#..........##.........##.#........................................#
###.##..##.#..#.##.##....#........................................#
###..........##....#######........................................#
########################################################################